1,0,0,0,0,0,0,0,0,0,0,0,0,0,0,0,0,0,0,0,0,0,0,0,1
1,0,0,0,0,0,0,0,0,0,0,0,0,0,0,0,0,0,0,0,0,0,0,0,1
1,0,0,0,0,0,0,0,0,0,0,0,0,0,0,0,0,0,0,0,0,0,0,0,1
1,0,0,0,0,0,0,0,0,0,0,0,0,0,0,0,0,0,0,0,0,0,0,0,1
1,0,0,0,0,0,0,0,0,0,0,0,0,0,0,0,0,0,0,0,0,0,0,0,1
1,0,0,0,0,0,0,0,0,0,0,0,0,0,0,0,0,0,0,0,0,0,0,0,1
4,0,0,0,0,0,0,0,0,0,0,0,0,0,0,0,0,0,0,0,0,0,0,0,1
7,4,0,0,0,0,0,0,0,0,0,0,0,0,0,0,0,0,0,0,0,0,0,0,1
7,7,5,0,0,0,0,0,0,0,0,0,0,0,0,0,0,0,0,0,0,0,0,0,7
7,7,7,0,0,0,0,0,0,0,0,0,0,0,0,0,0,0,0,0,0,0,0,0,7
7,0,7,0,0,0,0,0,0,0,0,0,0,0,0,0,0,0,0,0,0,0,0,0,7
7,0,6,7,7,4,5,4,5,4,0,0,0,0,0,0,0,0,0,0,0,0,0,0,7
7,0,0,6,6,6,0,7,7,7,4,4,5,4,5,4,0,0,0,0,0,0,0,0,7
7,0,0,0,0,0,0,0,0,7,7,7,7,7,7,7,5,5,0,0,0,0,0,5,7
7,0,0,0,0,0,0,0,0,0,0,0,0,0,0,0,0,0,0,0,0,4,5,7,7
7,7,0,0,0,0,0,0,0,0,0,0,0,0,0,0,0,0,4,5,4,7,7,0,7
7,7,4,0,0,0,0,0,0,0,0,0,0,0,0,5,4,5,7,7,7,0,0,0,7
7,6,7,0,0,0,0,0,0,0,0,0,5,4,4,7,7,7,7,0,0,0,0,0,7
7,6,7,4,5,0,0,0,0,0,0,4,7,0,0,0,0,0,0,0,0,0,0,0,7
7,7,7,6,7,4,5,4,5,0,0,0,0,0,0,0,0,0,0,0,0,0,0,0,7
7,6,6,6,6,6,6,6,7,5,4,4,5,0,0,0,0,0,0,0,0,0,0,0,7
7,7,6,7,6,6,6,7,6,6,7,6,6,4,4,4,4,4,4,4,4,4,0,0,7
7,0,0,0,0,0,0,0,0,0,0,0,0,0,0,0,0,0,0,0,0,0,0,0,7
7,4,5,4,5,5,4,4,4,5,4,5,4,4,4,5,4,5,4,5,4,5,4,4,7
6,7,7,6,7,6,7,7,6,7,6,6,7,7,7,6,7,7,6,7,6,6,7,7,6
