0,1,2,0,0,0,0,0,0,0,0
0,3,3,0,0,0,0,0,0,0,0
0,3,3,2,0,0,1,2,0,0,0
0,3,3,3,0,1,2,1,2,0,0
0,3,3,3,0,3,3,3,3,0,0
0,3,3,3,3,3,3,3,3,3,0
4,4,4,3,3,3,3,3,3,3,1
4,4,4,4,4,4,4,4,4,3,3
